NO ./textures/wall_north.xpm
SO ./textures/wall_south.xpm
WE ./textures/wall_west.xpm
EA ./textures/wall_east.xpm

F 45,30,15
C 135,206,235

111111111111111111111111111111111111111111111111111111111111111111111111111111
100000000000000000000000000000000000000000000000000000000000000000000000000001
100000000000000000000000000000000000000000000000000000000000000000000000000001
100011111111111000111111111111100011111111111110001111111111111000111111100001





100010000000001000100000000000100010000000000010001000000000001000100000100001
100010000000001000100000000000100010000000000010001000000000001000100000100001
100010001111001000100011111100100010001111110010001000111111001000100000100001
100010001001001000100010000100100010001000010010001000100001001000100000100001
100010001001001000100010000100100010001000010010001000100001001000111111100001
100010001001001000100010000100100010001000010010001000100001001000000000000001
100011111001111000111110000111100011111000011110001111100001111000000000000001
100000000000000000000000000000000000000000000000000000000000000000000000000001
100000000000000000000000000000000000000000000000000000000000000000000000000001
111111111001111111111111001111111111111100111111111111110011111111111110011111
100000001001000000000001001000000000000100100000000000010010000000000010010001
100000001001000000000001001000000000000100100000000000010010000000000010010001
100111001001001111110001001001111111100100100110111110010010011111110010010001
100101001001001000010001001001000000100100100100000010010010010000010010010001
100101001001001000010001001001000000100100100100000010010010010000010010010001
100101001111001000010001111001000000100111100100000010011110010000010011110001
100101000000001000010000000001000000100000000100000010000000010000010000000001
100101000000001000010000000001000000100000000100000010000000010000010000000001
100111111111111000011111111111000000111111111100000011111111110000011111111001
100000000000000000000000000000000000000000000000000000000000000000000000000001
100000000000000000000000000000000000000000000000000000000000000000000000000001
111111111111111111111111111111111001111111111111111111111111111111111111111001
100000000000000000000000000000001001000000000000000000000000000000000000001001
100000000000000000000000000000001001000000000000000000000000000000000000001001
100111111111111111111111111111001001001111111111111111111111111111111111001001
100100000000000000000000000001001001001000000000000000000000000000000001001001
100100000000000000000000000001001001001000000000000000000000000000000001001001
100100111111111111111111111001001111001001111111111111111111111111111001001001
100100100000000000000000001001000000001001000000000000000000000000001001001001
100100100000000000000000001001000N00001001000000000000000000000000001001001001
100100100111111111111111001001111111111001001111111111111111111111001001001001
100100100100000000000001001001000000000001001000000000000000000001001001001001
100100100100000000000001001001000000000001001000000000000000000001001001001001
100100100100111111111001001001001111111111001001111111111111111001001001001001
100100100100100000001001001001001000000000001001000000000000001001001001001001
100100100100100000001001001001001000000000001001000000000000001001001001001001
100100100100100111001001001001001001111111111001001111111111001001001001001001
100100100100100101001001001001001001000000000001001000000001001001001001001001
100100100100100101001001001001001001000000000001001000000001001001001001001001
100100100100100101001001001001001001111111111111001111111001001001001001001001
100100100100100101001001001001001000000000000000000000001001001001001001001001
100100100100100101001001001001001000000000000000000000001001001001001001001001
100100100100100101001111001111001111111111111111111111001001111001111001111001
100100100100100101000000000000000000000000000000000001001000000000000000000001
100100100100100101000000000000000000000000000000000001001000000000000000000001
100100100100100111111111111111111111111111111111111001001111111111111111111001
100100100100100000000000000000000000000000000000001001000000000000000000001001
100100100100100000000000000000000000000000000000001001000000000000000000001001
100100100100111111111111111111111111111111111111001001111111111111111111001001
100100100100000000000000000000000000000000000001001000000000000000000001001001
100100100100000000000000000000000000000000000001001000000000000000000001001001
100100100111111111111111111111111111111111111001001111111111111111111001001001
100100100000000000000000000000000000000000001001000000000000000000001001001001
100100100000000000000000000000000000000000001001000000000000000000001001001001
100100111111111111111111111111111111111111001001111111111111111111001001001001
100100000000000000000000000000000000000001001000000000000000000001001001001001
100100000000000000000000000000000000000001001000000000000000000001001001001001
100111111111111111111111111111111111111001111111111111111111111001111001111001
100000000000000000000000000000000000001000000000000000000000001000000000000001
100000000000000000000000000000000000001000000000000000000000001000000000000001
111111111111111111111111111111111111111111111111111111111111111111111111111111