NO ./textures/wall_north.xpm
NO ./textures/wall_north.xpm
SO ./textures/wall_south.xpm
SO ./textures/wall_south.xpm
WE ./textures/wall_west.xpm
EA ./textures/wall_east.xpm
F 255,0,0
F 0,255,0
C 0,255,0
C 255,0,0

1111
1W01
1111
