# texture definition
NO ./ /*path to NO.texture*/
SO ./ /*path to SO.texture*/
WE ./ /*path to We.texture*/
EA ./ /*path to EA.texture*/

# colour in rgb format 0-255
# (ive reversed floor and ceiling purposefully
# as it could be funny to build a reverse world ?)

#  floor, blue sky
F 135,206,235
# ceiling, brown walnut wood
C 100,60,30

# MAPS INVALIDS FOR TESTING

# Unclosed map

# 111111
# 100001
# 1000N1
# 10001
# 11111

# No player (N, S, E or W)

# 111111
# 100001
# 100001
# 100001
# 111111

# X aint valid char

# 111111
# 1S0001
# 10X001
# 100001
# 111111

# VALID MAPS

# Kanye West side player start

111111111
100000001
100000001
10000W001
100000001
111111111

# Eazy-East side player start

# 1111111111111   1111111111111111111
1111111111111111111111111111111111
# 10000000000000000000000000000001
# 10000000000000000000000000000001
# 10000000000000000000000000000001
# 10000000111110000000000000000001
# 10000000100010000000000000000001
# 10000000100010000000111111100001
# 10000000111110000000100000100001
# 10000000000000000000100000100001
# 10000001111100000000100000100001
# 10000001000100000000111111100001
# 10000001000100000000000000000001
# 10000001111100000000000000000001
# 10000000000000000000000000000001
# 100000000000000000001111111111111111
# 100000000000000000001000000000000001
# 100000000000000000001000000000000001
# 100000000000000000001000000000000001
# 100000000000000000001000000000000001
# 10000000000111111111100000000000001
# 10000000000100000000000000000000001
# 10000000000100000000000000000000001
# 10000000000100000000000000000000001
# 10000000000111111111111111000000001
# 10000000000000000000000001000000001
# 10000000000000000000000001000000001
# 10000000000000000000000001000000001
# 10000000000000000E00000001000000001
# 10000000000000000000000001000000001
# 10000000000000000000000001000000001
# 10000000000000000000000000000000001
# 11111111111111111111111111111111111


while (readbytes > 0)

IF (STASH = \n)
