NO ./textures/wall_north.xpm
WE ./textures/wall_west.xpm
F 255,0,0

1111
1W01
1111
