NO ./textures/wall_north.xpm
SO ./textures/wall_south.xpm  
WE ./textures/wall_west.xpm
EA ./textures/wall_east.xpm

F 220,100,0
C 225,30,0

1111111111111111111111111
1000011111111101110101001
1100000011010101110000001
1111111111011W01001111111
1111111111111111111111111
