NO ./textures/wall_north.xpm
SO ./textures/wall_south.xpm
WE ./textures/wall_west.xpm
EA ./textures/wall_east.xpm

F 013,100, 31
C 178,30,12

1111111111111111111111111
1000000000110000000000001
1011000001110000000000001
1001000000000000000000001
1111111111011001011100001
1000000000110000011101111
1111011111111001110000001
1000011111111101110101001
1100000011010101110000001
1111111111011W01001111111
1000000000000000110101001
1100000111010111111011111
1111011101110101110111101
1111111111111111111111111